
phone-slash|fas fa-phone-slash
heart-regular|far fa-heart
chess-queen|fas fa-chess-queen
first-aid|fas fa-first-aid
align-center|fas fa-align-center
barcode|fas fa-barcode
question|fas fa-question
napster|fab fa-napster
circle|fas fa-circle
hand-point-right|fas fa-hand-point-right
aviato|fab fa-aviato
tablet-alt|fas fa-tablet-alt
window-close|fas fa-window-close
dove|fas fa-dove
lightbulb-regular|far fa-lightbulb
superscript|fas fa-superscript
codiepie|fab fa-codiepie
share-alt|fas fa-share-alt
user-secret|fas fa-user-secret
money-bill-alt|fas fa-money-bill-alt
table-tennis|fas fa-table-tennis
gitkraken|fab fa-gitkraken
i-cursor|fas fa-i-cursor
smile-regular|far fa-smile
soundcloud|fab fa-soundcloud
arrow-alt-circle-up|fas fa-arrow-alt-circle-up
square-full|fas fa-square-full
space-shuttle|fas fa-space-shuttle
ticket-alt|fas fa-ticket-alt
sun-regular|far fa-sun
users|fas fa-users
list-ul|fas fa-list-ul
facebook-square|fab fa-facebook-square
font-awesome|fab fa-font-awesome
xing-square|fab fa-xing-square
bookmark|fas fa-bookmark
box-open|fas fa-box-open
sort-numeric-down|fas fa-sort-numeric-down
database|fas fa-database
ruble-sign|fas fa-ruble-sign
external-link-alt|fas fa-external-link-alt
file-excel-regular|far fa-file-excel
yahoo|fab fa-yahoo
caret-right|fas fa-caret-right
lyft|fab fa-lyft
viacoin|fab fa-viacoin
discourse|fab fa-discourse
mouse-pointer|fas fa-mouse-pointer
vial|fas fa-vial
weixin|fab fa-weixin
comment|fas fa-comment
ravelry|fab fa-ravelry
bell-slash|fas fa-bell-slash
file-regular|far fa-file
clipboard-list|fas fa-clipboard-list
folder-regular|far fa-folder
cpanel|fab fa-cpanel
futbol-regular|far fa-futbol
wordpress|fab fa-wordpress
share|fas fa-share
envelope-open-regular|far fa-envelope-open
trash-alt-regular|far fa-trash-alt
thermometer-three-quarters|fas fa-thermometer-three-quarters
tachometer-alt|fas fa-tachometer-alt
stripe|fab fa-stripe
subscript|fas fa-subscript
check-square-regular|far fa-check-square
hooli|fab fa-hooli
pushed|fab fa-pushed
blackberry|fab fa-blackberry
credit-card-regular|far fa-credit-card
sticky-note-regular|far fa-sticky-note
arrows-alt|fas fa-arrows-alt
arrow-circle-left|fas fa-arrow-circle-left
battery-half|fas fa-battery-half
info-circle|fas fa-info-circle
eye-slash|fas fa-eye-slash
forward|fas fa-forward
chevron-circle-down|fas fa-chevron-circle-down
file-pdf|fas fa-file-pdf
foursquare|fab fa-foursquare
mizuni|fab fa-mizuni
university|fas fa-university
stack-overflow|fab fa-stack-overflow
deploydog|fab fa-deploydog
google-plus-g|fab fa-google-plus-g
share-square|fas fa-share-square
exclamation-circle|fas fa-exclamation-circle
bus|fas fa-bus
window-minimize|fas fa-window-minimize
search-minus|fas fa-search-minus
css3|fab fa-css3
dot-circle|fas fa-dot-circle
cut|fas fa-cut
line|fab fa-line
code|fas fa-code
battery-empty|fas fa-battery-empty
affiliatetheme|fab fa-affiliatetheme
vine|fab fa-vine
hand-point-up-regular|far fa-hand-point-up
building|fas fa-building
itunes-note|fab fa-itunes-note
safari|fab fa-safari
h-square|fas fa-h-square
minus|fas fa-minus
caret-left|fas fa-caret-left
angellist|fab fa-angellist
shower|fas fa-shower
map-marker|fas fa-map-marker
blogger|fab fa-blogger
magic|fas fa-magic
clock|fas fa-clock
xbox|fab fa-xbox
file-code-regular|far fa-file-code
twitter|fab fa-twitter
phone|fas fa-phone
algolia|fab fa-algolia
sign-in-alt|fas fa-sign-in-alt
images-regular|far fa-images
burn|fas fa-burn
th-list|fas fa-th-list
arrow-right|fas fa-arrow-right
file-code|fas fa-file-code
lightbulb|fas fa-lightbulb
snowflake-regular|far fa-snowflake
redo|fas fa-redo
window-restore-regular|far fa-window-restore
caret-square-left|fas fa-caret-square-left
sort-down|fas fa-sort-down
draft2digital|fab fa-draft2digital
taxi|fas fa-taxi
stop|fas fa-stop
twitch|fab fa-twitch
mercury|fas fa-mercury
get-pocket|fab fa-get-pocket
telegram|fab fa-telegram
genderless|fas fa-genderless
paragraph|fas fa-paragraph
angrycreative|fab fa-angrycreative
html5|fab fa-html5
monero|fab fa-monero
object-ungroup-regular|far fa-object-ungroup
chevron-up|fas fa-chevron-up
cc-stripe|fab fa-cc-stripe
calendar-times|fas fa-calendar-times
youtube|fab fa-youtube
money-bill-alt-regular|far fa-money-bill-alt
hand-point-down|fas fa-hand-point-down
expeditedssl|fab fa-expeditedssl
apple|fab fa-apple
long-arrow-alt-right|fas fa-long-arrow-alt-right
unlock|fas fa-unlock
camera|fas fa-camera
image|fas fa-image
minus-circle|fas fa-minus-circle
rendact|fab fa-rendact
clone|fas fa-clone
odnoklassniki|fab fa-odnoklassniki
schlix|fab fa-schlix
joomla|fab fa-joomla
cc-amex|fab fa-cc-amex
object-ungroup|fas fa-object-ungroup
arrows-alt-v|fas fa-arrows-alt-v
hand-spock-regular|far fa-hand-spock
piggy-bank|fas fa-piggy-bank
fast-forward|fas fa-fast-forward
file-alt|fas fa-file-alt
search-plus|fas fa-search-plus
osi|fab fa-osi
male|fas fa-male
bowling-ball|fas fa-bowling-ball
cloud|fas fa-cloud
clone-regular|far fa-clone
keyboard|fas fa-keyboard
toggle-off|fas fa-toggle-off
envelope-open|fas fa-envelope-open
pagelines|fab fa-pagelines
stopwatch|fas fa-stopwatch
audio-description|fas fa-audio-description
terminal|fas fa-terminal
wpforms|fab fa-wpforms
circle-regular|far fa-circle
korvue|fab fa-korvue
key|fas fa-key
caret-square-up-regular|far fa-caret-square-up
yen-sign|fas fa-yen-sign
life-ring|fas fa-life-ring
facebook-messenger|fab fa-facebook-messenger
accusoft|fab fa-accusoft
upload|fas fa-upload
couch|fas fa-couch
gavel|fas fa-gavel
vials|fas fa-vials
slideshare|fab fa-slideshare
snapchat-square|fab fa-snapchat-square
flipboard|fab fa-flipboard
resolving|fab fa-resolving
cc-visa|fab fa-cc-visa
bars|fas fa-bars
comment-alt-regular|far fa-comment-alt
magnet|fas fa-magnet
bitbucket|fab fa-bitbucket
italic|fas fa-italic
mars-double|fas fa-mars-double
wikipedia-w|fab fa-wikipedia-w
snowflake|fas fa-snowflake
sort-alpha-down|fas fa-sort-alpha-down
fax|fas fa-fax
hand-point-left-regular|far fa-hand-point-left
procedures|fas fa-procedures
lemon-regular|far fa-lemon
backward|fas fa-backward
adjust|fas fa-adjust
neuter|fas fa-neuter
chart-area|fas fa-chart-area
docker|fab fa-docker
github|fab fa-github
chart-pie|fas fa-chart-pie
medkit|fas fa-medkit
user-times|fas fa-user-times
level-down-alt|fas fa-level-down-alt
hotjar|fab fa-hotjar
caret-square-left-regular|far fa-caret-square-left
exchange-alt|fas fa-exchange-alt
ellipsis-v|fas fa-ellipsis-v
expand-arrows-alt|fas fa-expand-arrows-alt
battery-full|fas fa-battery-full
certificate|fas fa-certificate
share-alt-square|fas fa-share-alt-square
npm|fab fa-npm
ban|fas fa-ban
dochub|fab fa-dochub
js-square|fab fa-js-square
user-md|fas fa-user-md
poo|fas fa-poo
jenkins|fab fa-jenkins
clipboard|fas fa-clipboard
bug|fas fa-bug
cogs|fas fa-cogs
instagram|fab fa-instagram
hand-paper-regular|far fa-hand-paper
caret-down|fas fa-caret-down
tripadvisor|fab fa-tripadvisor
mars-stroke-v|fas fa-mars-stroke-v
bandcamp|fab fa-bandcamp
building-regular|far fa-building
thermometer-half|fas fa-thermometer-half
dot-circle-regular|far fa-dot-circle
cart-arrow-down|fas fa-cart-arrow-down
folder-open|fas fa-folder-open
viadeo|fab fa-viadeo
cog|fas fa-cog
chevron-circle-up|fas fa-chevron-circle-up
cc-paypal|fab fa-cc-paypal
eye|fas fa-eye
beer|fas fa-beer
bitcoin|fab fa-bitcoin
trash|fas fa-trash
question-circle-regular|far fa-question-circle
medium|fab fa-medium
stop-circle-regular|far fa-stop-circle
jsfiddle|fab fa-jsfiddle
gitlab|fab fa-gitlab
untappd|fab fa-untappd
shekel-sign|fas fa-shekel-sign
opera|fab fa-opera
bimobject|fab fa-bimobject
angle-double-right|fas fa-angle-double-right
contao|fab fa-contao
medapps|fab fa-medapps
mix|fab fa-mix
venus-double|fas fa-venus-double
arrow-alt-circle-down|fas fa-arrow-alt-circle-down
hand-holding-heart|fas fa-hand-holding-heart
yandex-international|fab fa-yandex-international
skyatlas|fab fa-skyatlas
prescription-bottle-alt|fas fa-prescription-bottle-alt
free-code-camp|fab fa-free-code-camp
unlock-alt|fas fa-unlock-alt
external-link-square-alt|fas fa-external-link-square-alt
hand-peace-regular|far fa-hand-peace
film|fas fa-film
address-book|fas fa-address-book
arrow-alt-circle-left|fas fa-arrow-alt-circle-left
goodreads-g|fab fa-goodreads-g
accessible-icon|fab fa-accessible-icon
undo|fas fa-undo
umbrella|fas fa-umbrella
pinterest|fab fa-pinterest
boxes|fas fa-boxes
gift|fas fa-gift
quote-left|fas fa-quote-left
forumbee|fab fa-forumbee
phoenix-framework|fab fa-phoenix-framework
d-and-d|fab fa-d-and-d
bullhorn|fas fa-bullhorn
dropbox|fab fa-dropbox
arrow-circle-right|fas fa-arrow-circle-right
times-circle|fas fa-times-circle
futbol|fas fa-futbol
map-pin|fas fa-map-pin
square-regular|far fa-square
vimeo-v|fab fa-vimeo-v
hips|fab fa-hips
red-river|fab fa-red-river
paperclip|fas fa-paperclip
flag-checkered|fas fa-flag-checkered
clock-regular|far fa-clock
crosshairs|fas fa-crosshairs
sun|fas fa-sun
check|fas fa-check
viber|fab fa-viber
bomb|fas fa-bomb
github-square|fab fa-github-square
power-off|fas fa-power-off
file-word-regular|far fa-file-word
sort-amount-up|fas fa-sort-amount-up
searchengin|fab fa-searchengin
file-archive-regular|far fa-file-archive
freebsd|fab fa-freebsd
life-ring-regular|far fa-life-ring
hand-peace|fas fa-hand-peace
etsy|fab fa-etsy
arrow-alt-circle-left-regular|far fa-arrow-alt-circle-left
scribd|fab fa-scribd
deaf|fas fa-deaf
buromobelexperte|fab fa-buromobelexperte
tint|fas fa-tint
hospital-alt|fas fa-hospital-alt
pause|fas fa-pause
deviantart|fab fa-deviantart
fire|fas fa-fire
lock-open|fas fa-lock-open
prescription-bottle|fas fa-prescription-bottle
star|fas fa-star
chart-bar-regular|far fa-chart-bar
pied-piper-alt|fab fa-pied-piper-alt
gem-regular|far fa-gem
wpexplorer|fab fa-wpexplorer
angle-double-up|fas fa-angle-double-up
level-up-alt|fas fa-level-up-alt
eye-slash-regular|far fa-eye-slash
hourglass|fas fa-hourglass
gripfire|fab fa-gripfire
trash-alt|fas fa-trash-alt
thermometer-quarter|fas fa-thermometer-quarter
mars|fas fa-mars
laravel|fab fa-laravel
angle-left|fas fa-angle-left
vaadin|fab fa-vaadin
font-awesome-flag|fab fa-font-awesome-flag
edit|fas fa-edit
fast-backward|fas fa-fast-backward
transgender-alt|fas fa-transgender-alt
hands-helping|fas fa-hands-helping
shopping-cart|fas fa-shopping-cart
calendar-regular|far fa-calendar
chevron-right|fas fa-chevron-right
clipboard-check|fas fa-clipboard-check
ussunnah|fab fa-ussunnah
paper-plane-regular|far fa-paper-plane
circle-notch|fas fa-circle-notch
check-square|fas fa-check-square
hand-paper|fas fa-hand-paper
basketball-ball|fas fa-basketball-ball
bity|fab fa-bity
envira|fab fa-envira
user|fas fa-user
gitter|fab fa-gitter
diagnoses|fas fa-diagnoses
briefcase-medical|fas fa-briefcase-medical
tablets|fas fa-tablets
kickstarter-k|fab fa-kickstarter-k
sign|fas fa-sign
file-audio-regular|far fa-file-audio
calendar-times-regular|far fa-calendar-times
calendar|fas fa-calendar
linkedin|fab fa-linkedin
id-badge|fas fa-id-badge
stethoscope|fas fa-stethoscope
hire-a-helper|fab fa-hire-a-helper
stripe-s|fab fa-stripe-s
fort-awesome|fab fa-fort-awesome
sitemap|fas fa-sitemap
chess-king|fas fa-chess-king
hand-holding-usd|fas fa-hand-holding-usd
headphones|fas fa-headphones
wordpress-simple|fab fa-wordpress-simple
tumblr-square|fab fa-tumblr-square
mars-stroke-h|fas fa-mars-stroke-h
less|fab fa-less
chart-bar|fas fa-chart-bar
js|fab fa-js
behance|fab fa-behance
football-ball|fas fa-football-ball
slack-hash|fab fa-slack-hash
won-sign|fas fa-won-sign
list-alt|fas fa-list-alt
ellipsis-h|fas fa-ellipsis-h
plug|fas fa-plug
mixcloud|fab fa-mixcloud
battery-quarter|fas fa-battery-quarter
simplybuilt|fab fa-simplybuilt
syringe|fas fa-syringe
puzzle-piece|fas fa-puzzle-piece
code-branch|fas fa-code-branch
weight|fas fa-weight
transgender|fas fa-transgender
wrench|fas fa-wrench
gg-circle|fab fa-gg-circle
trademark|fas fa-trademark
closed-captioning|fas fa-closed-captioning
wine-glass|fas fa-wine-glass
heartbeat|fas fa-heartbeat
volume-down|fas fa-volume-down
sort-up|fas fa-sort-up
reddit|fab fa-reddit
hand-point-left|fas fa-hand-point-left
caret-up|fas fa-caret-up
sticker-mule|fab fa-sticker-mule
adversal|fab fa-adversal
ns8|fab fa-ns8
handshake|fas fa-handshake
angle-right|fas fa-angle-right
bed|fas fa-bed
microchip|fas fa-microchip
lastfm|fab fa-lastfm
font|fas fa-font
gem|fas fa-gem
spinner|fas fa-spinner
vuejs|fab fa-vuejs
chevron-down|fas fa-chevron-down
cloudscale|fab fa-cloudscale
text-width|fas fa-text-width
tumblr|fab fa-tumblr
quidditch|fas fa-quidditch
angle-down|fas fa-angle-down
snapchat-ghost|fab fa-snapchat-ghost
spotify|fab fa-spotify
archive|fas fa-archive
first-order|fab fa-first-order
compass|fas fa-compass
file|fas fa-file
dyalog|fab fa-dyalog
search|fas fa-search
exclamation|fas fa-exclamation
paper-plane|fas fa-paper-plane
leaf|fas fa-leaf
aws|fab fa-aws
buysellads|fab fa-buysellads
file-image-regular|far fa-file-image
keyboard-regular|far fa-keyboard
readme|fab fa-readme
hands|fas fa-hands
sass|fab fa-sass
fort-awesome-alt|fab fa-fort-awesome-alt
calendar-plus|fas fa-calendar-plus
php|fab fa-php
briefcase|fas fa-briefcase
edge|fab fa-edge
speakap|fab fa-speakap
file-pdf-regular|far fa-file-pdf
location-arrow|fas fa-location-arrow
utensil-spoon|fas fa-utensil-spoon
phabricator|fab fa-phabricator
file-image|fas fa-file-image
utensils|fas fa-utensils
bullseye|fas fa-bullseye
flag|fas fa-flag
rss-square|fas fa-rss-square
fire-extinguisher|fas fa-fire-extinguisher
gratipay|fab fa-gratipay
desktop|fas fa-desktop
cloudversify|fab fa-cloudversify
delicious|fab fa-delicious
reddit-alien|fab fa-reddit-alien
table|fas fa-table
quote-right|fas fa-quote-right
discord|fab fa-discord
comment-alt|fas fa-comment-alt
kickstarter|fab fa-kickstarter
caret-square-right-regular|far fa-caret-square-right
copy|fas fa-copy
copy-regular|far fa-copy
long-arrow-alt-down|fas fa-long-arrow-alt-down
step-backward|fas fa-step-backward
youtube-square|fab fa-youtube-square
train|fas fa-train
tencent-weibo|fab fa-tencent-weibo
people-carry|fas fa-people-carry
grunt|fab fa-grunt
chart-line|fas fa-chart-line
empire|fab fa-empire
black-tie|fab fa-black-tie
star-half-regular|far fa-star-half
object-group|fas fa-object-group
cube|fas fa-cube
modx|fab fa-modx
ship|fas fa-ship
align-right|fas fa-align-right
flask|fas fa-flask
address-card|fas fa-address-card
earlybirds|fab fa-earlybirds
behance-square|fab fa-behance-square
music|fas fa-music
node|fab fa-node
yelp|fab fa-yelp
crop|fas fa-crop
rupee-sign|fas fa-rupee-sign
mobile-alt|fas fa-mobile-alt
balance-scale|fas fa-balance-scale
calendar-alt-regular|far fa-calendar-alt
git|fab fa-git
css3-alt|fab fa-css3-alt
cc-discover|fab fa-cc-discover
hand-scissors-regular|far fa-hand-scissors
flag-regular|far fa-flag
sync|fas fa-sync
heart|fas fa-heart
comments-regular|far fa-comments
user-regular|far fa-user
hand-spock|fas fa-hand-spock
star-regular|far fa-star
indent|fas fa-indent
calendar-minus|fas fa-calendar-minus
user-circle|fas fa-user-circle
home|fas fa-home
band-aid|fas fa-band-aid
google|fab fa-google
thumbs-up-regular|far fa-thumbs-up
pills|fas fa-pills
skype|fab fa-skype
chrome|fab fa-chrome
servicestack|fab fa-servicestack
digg|fab fa-digg
amilia|fab fa-amilia
chevron-circle-right|fas fa-chevron-circle-right
stop-circle|fas fa-stop-circle
smile|fas fa-smile
github-alt|fab fa-github-alt
stumbleupon|fab fa-stumbleupon
500px|fab fa-500px
object-group-regular|far fa-object-group
chevron-circle-left|fas fa-chevron-circle-left
copyright|fas fa-copyright
hashtag|fas fa-hashtag
arrow-left|fas fa-arrow-left
window-maximize|fas fa-window-maximize
long-arrow-alt-left|fas fa-long-arrow-alt-left
golf-ball|fas fa-golf-ball
caret-square-down|fas fa-caret-square-down
comments|fas fa-comments
cart-plus|fas fa-cart-plus
vimeo|fab fa-vimeo
laptop|fas fa-laptop
sort|fas fa-sort
facebook-f|fab fa-facebook-f
bluetooth|fab fa-bluetooth
hand-point-right-regular|far fa-hand-point-right
angle-double-left|fas fa-angle-double-left
chess-pawn|fas fa-chess-pawn
caret-square-right|fas fa-caret-square-right
glide-g|fab fa-glide-g
outdent|fas fa-outdent
hand-holding|fas fa-hand-holding
toggle-on|fas fa-toggle-on
reply|fas fa-reply
battery-three-quarters|fas fa-battery-three-quarters
file-medical|fas fa-file-medical
superpowers|fab fa-superpowers
autoprefixer|fab fa-autoprefixer
yandex|fab fa-yandex
venus-mars|fas fa-venus-mars
bell-regular|far fa-bell
whmcs|fab fa-whmcs
pinterest-p|fab fa-pinterest-p
dolly|fas fa-dolly
joget|fab fa-joget
openid|fab fa-openid
window-maximize-regular|far fa-window-maximize
cc-mastercard|fab fa-cc-mastercard
google-wallet|fab fa-google-wallet
tag|fas fa-tag
arrow-down|fas fa-arrow-down
handshake-regular|far fa-handshake
shield-alt|fas fa-shield-alt
window-restore|fas fa-window-restore
notes-medical|fas fa-notes-medical
female|fas fa-female
ambulance|fas fa-ambulance
map-regular|far fa-map
arrow-up|fas fa-arrow-up
periscope|fab fa-periscope
quora|fab fa-quora
asterisk|fas fa-asterisk
qq|fab fa-qq
stumbleupon-circle|fab fa-stumbleupon-circle
dolly-flatbed|fas fa-dolly-flatbed
closed-captioning-regular|far fa-closed-captioning
window-minimize-regular|far fa-window-minimize
book|fas fa-book
git-square|fab fa-git-square
hand-point-down-regular|far fa-hand-point-down
capsules|fas fa-capsules
cc-jcb|fab fa-cc-jcb
arrow-alt-circle-right-regular|far fa-arrow-alt-circle-right
vk|fab fa-vk
chess-bishop|fas fa-chess-bishop
fly|fab fa-fly
y-combinator|fab fa-y-combinator
filter|fas fa-filter
arrow-alt-circle-right|fas fa-arrow-alt-circle-right
centercode|fab fa-centercode
hand-pointer|fas fa-hand-pointer
pied-piper-pp|fab fa-pied-piper-pp
pinterest-square|fab fa-pinterest-square
parachute-box|fas fa-parachute-box
node-js|fab fa-node-js
bell-slash-regular|far fa-bell-slash
rebel|fab fa-rebel
arrow-alt-circle-up-regular|far fa-arrow-alt-circle-up
file-archive|fas fa-file-archive
xing|fab fa-xing
file-word|fas fa-file-word
eye-dropper|fas fa-eye-dropper
bold|fas fa-bold
registered-regular|far fa-registered
thumbtack|fas fa-thumbtack
image-regular|far fa-image
seedling|fas fa-seedling
vimeo-square|fab fa-vimeo-square
caret-square-down-regular|far fa-caret-square-down
slack|fab fa-slack
eraser|fas fa-eraser
calendar-alt|fas fa-calendar-alt
address-book-regular|far fa-address-book
rocket|fas fa-rocket
share-square-regular|far fa-share-square
fighter-jet|fas fa-fighter-jet
braille|fas fa-braille
dribbble|fab fa-dribbble
plane|fas fa-plane
patreon|fab fa-patreon
trello|fab fa-trello
list-alt-regular|far fa-list-alt
palfed|fab fa-palfed
globe|fas fa-globe
apple-pay|fab fa-apple-pay
hand-point-up|fas fa-hand-point-up
paypal|fab fa-paypal
newspaper-regular|far fa-newspaper
leanpub|fab fa-leanpub
moon-regular|far fa-moon
sellsy|fab fa-sellsy
gofore|fab fa-gofore
gamepad|fas fa-gamepad
playstation|fab fa-playstation
long-arrow-alt-up|fas fa-long-arrow-alt-up
pen-square|fas fa-pen-square
heading|fas fa-heading
file-audio|fas fa-file-audio
thermometer-full|fas fa-thermometer-full
calendar-plus-regular|far fa-calendar-plus
file-powerpoint|fas fa-file-powerpoint
subway|fas fa-subway
hand-lizard|fas fa-hand-lizard
internet-explorer|fab fa-internet-explorer
connectdevelop|fab fa-connectdevelop
android|fab fa-android
flickr|fab fa-flickr
usb|fab fa-usb
staylinked|fab fa-staylinked
firefox|fab fa-firefox
road|fas fa-road
minus-square-regular|far fa-minus-square
steam-symbol|fab fa-steam-symbol
trophy|fas fa-trophy
google-play|fab fa-google-play
wifi|fas fa-wifi
pause-circle-regular|far fa-pause-circle
lira-sign|fas fa-lira-sign
yoast|fab fa-yoast
retweet|fas fa-retweet
coffee|fas fa-coffee
volleyball-ball|fas fa-volleyball-ball
dashcube|fab fa-dashcube
id-card-regular|far fa-id-card
envelope-regular|far fa-envelope
audible|fab fa-audible
list-ol|fas fa-list-ol
edit-regular|far fa-edit
folder|fas fa-folder
volume-up|fas fa-volume-up
microsoft|fab fa-microsoft
id-badge-regular|far fa-id-badge
typo3|fab fa-typo3
server|fas fa-server
lemon|fas fa-lemon
elementor|fab fa-elementor
american-sign-language-interpreting|fas fa-american-sign-language-interpreting
google-plus-square|fab fa-google-plus-square
images|fas fa-images
facebook|fab fa-facebook
weibo|fab fa-weibo
at|fas fa-at
hospital-regular|far fa-hospital
cloud-download-alt|fas fa-cloud-download-alt
angular|fab fa-angular
nintendo-switch|fab fa-nintendo-switch
truck|fas fa-truck
adn|fab fa-adn
th-large|fas fa-th-large
hdd|fas fa-hdd
save-regular|far fa-save
goodreads|fab fa-goodreads
lastfm-square|fab fa-lastfm-square
file-medical-alt|fas fa-file-medical-alt
plus-square|fas fa-plus-square
warehouse|fas fa-warehouse
motorcycle|fas fa-motorcycle
shirtsinbulk|fab fa-shirtsinbulk
supple|fab fa-supple
download|fas fa-download
dollar-sign|fas fa-dollar-sign
reply-all|fas fa-reply-all
chess-knight|fas fa-chess-knight
cubes|fas fa-cubes
strikethrough|fas fa-strikethrough
thumbs-up|fas fa-thumbs-up
glass-martini|fas fa-glass-martini
minus-square|fas fa-minus-square
tasks|fas fa-tasks
hospital-symbol|fas fa-hospital-symbol
low-vision|fas fa-low-vision
volume-off|fas fa-volume-off
font-awesome-alt|fab fa-font-awesome-alt
sort-amount-down|fas fa-sort-amount-down
address-card-regular|far fa-address-card
assistive-listening-systems|fas fa-assistive-listening-systems
comment-slash|fas fa-comment-slash
calendar-check-regular|far fa-calendar-check
baseball-ball|fas fa-baseball-ball
plus-circle|fas fa-plus-circle
optin-monster|fab fa-optin-monster
avianex|fab fa-avianex
mars-stroke|fas fa-mars-stroke
pound-sign|fas fa-pound-sign
hdd-regular|far fa-hdd
sellcast|fab fa-sellcast
euro-sign|fas fa-euro-sign
reddit-square|fab fa-reddit-square
language|fas fa-language
asymmetrik|fab fa-asymmetrik
user-plus|fas fa-user-plus
file-alt-regular|far fa-file-alt
sign-language|fas fa-sign-language
print|fas fa-print
digital-ocean|fab fa-digital-ocean
hand-scissors|fas fa-hand-scissors
paste|fas fa-paste
viadeo-square|fab fa-viadeo-square
calendar-check|fas fa-calendar-check
replyd|fab fa-replyd
react|fab fa-react
meh|fas fa-meh
hospital|fas fa-hospital
blogger-b|fab fa-blogger-b
clipboard-regular|far fa-clipboard
graduation-cap|fas fa-graduation-cap
sistrix|fab fa-sistrix
stack-exchange|fab fa-stack-exchange
dribbble-square|fab fa-dribbble-square
envelope|fas fa-envelope
keycdn|fab fa-keycdn
houzz|fab fa-houzz
chess-board|fas fa-chess-board
amazon-pay|fab fa-amazon-pay
save|fas fa-save
maxcdn|fab fa-maxcdn
windows|fab fa-windows
hand-lizard-regular|far fa-hand-lizard
hourglass-start|fas fa-hourglass-start
text-height|fas fa-text-height
deskpro|fab fa-deskpro
codepen|fab fa-codepen
cc-diners-club|fab fa-cc-diners-club
eject|fas fa-eject
file-video|fas fa-file-video
credit-card|fas fa-credit-card
video|fas fa-video
compress|fas fa-compress
fonticons-fi|fab fa-fonticons-fi
vnv|fab fa-vnv
birthday-cake|fas fa-birthday-cake
thermometer-empty|fas fa-thermometer-empty
magento|fab fa-magento
bath|fas fa-bath
check-circle|fas fa-check-circle
medium-m|fab fa-medium-m
bluetooth-b|fab fa-bluetooth-b
hacker-news-square|fab fa-hacker-news-square
x-ray|fas fa-x-ray
square|fas fa-square
hourglass-end|fas fa-hourglass-end
id-card|fas fa-id-card
anchor|fas fa-anchor
compass-regular|far fa-compass
industry|fas fa-industry
podcast|fas fa-podcast
truck-loading|fas fa-truck-loading
gg|fab fa-gg
paw|fas fa-paw
angle-double-down|fas fa-angle-double-down
itunes|fab fa-itunes
binoculars|fas fa-binoculars
apper|fab fa-apper
cuttlefish|fab fa-cuttlefish
expand|fas fa-expand
truck-moving|fas fa-truck-moving
rockrms|fab fa-rockrms
bell|fas fa-bell
cc-apple-pay|fab fa-cc-apple-pay
hacker-news|fab fa-hacker-news
car|fas fa-car
map-marker-alt|fas fa-map-marker-alt
whatsapp|fab fa-whatsapp
tape|fas fa-tape
pause-circle|fas fa-pause-circle
child|fas fa-child
smoking|fas fa-smoking
sticky-note|fas fa-sticky-note
hand-pointer-regular|far fa-hand-pointer
align-justify|fas fa-align-justify
gulp|fab fa-gulp
user-circle-regular|far fa-user-circle
caret-square-up|fas fa-caret-square-up
linkedin-in|fab fa-linkedin-in
microphone-slash|fas fa-microphone-slash
angle-up|fas fa-angle-up
microphone|fas fa-microphone
sort-numeric-up|fas fa-sort-numeric-up
id-card-alt|fas fa-id-card-alt
suitcase|fas fa-suitcase
sync-alt|fas fa-sync-alt
comment-regular|far fa-comment
meetup|fab fa-meetup
recycle|fas fa-recycle
whatsapp-square|fab fa-whatsapp-square
play-circle-regular|far fa-play-circle
envelope-square|fas fa-envelope-square
studiovinari|fab fa-studiovinari
shopping-bag|fas fa-shopping-bag
box|fas fa-box
info|fas fa-info
blind|fas fa-blind
sign-out-alt|fas fa-sign-out-alt
google-drive|fab fa-google-drive
align-left|fas fa-align-left
uber|fab fa-uber
bolt|fas fa-bolt
newspaper|fas fa-newspaper
hand-rock-regular|far fa-hand-rock
signal|fas fa-signal
sort-alpha-up|fas fa-sort-alpha-up
mobile|fas fa-mobile
times|fas fa-times
registered|fas fa-registered
file-excel|fas fa-file-excel
chess-rook|fas fa-chess-rook
qrcode|fas fa-qrcode
snapchat|fab fa-snapchat
chess|fas fa-chess
star-half|fas fa-star-half
window-close-regular|far fa-window-close
app-store-ios|fab fa-app-store-ios
lock|fas fa-lock
plus-square-regular|far fa-plus-square
pied-piper|fab fa-pied-piper
universal-access|fas fa-universal-access
arrows-alt-h|fas fa-arrows-alt-h
percent|fas fa-percent
ribbon|fas fa-ribbon
underline|fas fa-underline
ioxhost|fab fa-ioxhost
app-store|fab fa-app-store
medrt|fab fa-medrt
hockey-puck|fas fa-hockey-puck
quinscape|fab fa-quinscape
telegram-plane|fab fa-telegram-plane
steam|fab fa-steam
page4|fab fa-page4
thumbs-down-regular|far fa-thumbs-down
product-hunt|fab fa-product-hunt
folder-open-regular|far fa-folder-open
donate|fas fa-donate
redo-alt|fas fa-redo-alt
question-circle|fas fa-question-circle
hubspot|fab fa-hubspot
thermometer|fas fa-thermometer
camera-retro|fas fa-camera-retro
calendar-minus-regular|far fa-calendar-minus
sliders-h|fas fa-sliders-h
shopping-basket|fas fa-shopping-basket
hourglass-regular|far fa-hourglass
thumbs-down|fas fa-thumbs-down
shipping-fast|fas fa-shipping-fast
steam-square|fab fa-steam-square
tablet|fas fa-tablet
plus|fas fa-plus
street-view|fas fa-street-view
strava|fab fa-strava
dna|fas fa-dna
play-circle|fas fa-play-circle
th|fas fa-th
allergies|fas fa-allergies
calculator|fas fa-calculator
paint-brush|fas fa-paint-brush
chevron-left|fas fa-chevron-left
frown|fas fa-frown
odnoklassniki-square|fab fa-odnoklassniki-square
bookmark-regular|far fa-bookmark
tree|fas fa-tree
link|fas fa-link
cc-amazon-pay|fab fa-cc-amazon-pay
hand-rock|fas fa-hand-rock
themeisle|fab fa-themeisle
times-circle-regular|far fa-times-circle
creative-commons|fab fa-creative-commons
meh-regular|far fa-meh
pallet|fas fa-pallet
ember|fab fa-ember
hourglass-half|fas fa-hourglass-half
video-slash|fas fa-video-slash
tty|fas fa-tty
glide|fab fa-glide
erlang|fab fa-erlang
wheelchair|fas fa-wheelchair
btc|fab fa-btc
file-video-regular|far fa-file-video
frown-regular|far fa-frown
tv|fas fa-tv
undo-alt|fas fa-undo-alt
cloud-upload-alt|fas fa-cloud-upload-alt
linode|fab fa-linode
phone-square|fas fa-phone-square
map|fas fa-map
check-circle-regular|far fa-check-circle
grav|fab fa-grav
wpbeginner|fab fa-wpbeginner
comment-dots|fas fa-comment-dots
tags|fas fa-tags
linux|fab fa-linux
arrow-alt-circle-down-regular|far fa-arrow-alt-circle-down
unlink|fas fa-unlink
pencil-alt|fas fa-pencil-alt
uniregistry|fab fa-uniregistry
python|fab fa-python
step-forward|fas fa-step-forward
phone-volume|fas fa-phone-volume
exclamation-triangle|fas fa-exclamation-triangle
file-powerpoint-regular|far fa-file-powerpoint
amazon|fab fa-amazon
imdb|fab fa-imdb
columns|fas fa-columns
renren|fab fa-renren
nutritionix|fab fa-nutritionix
drupal|fab fa-drupal
random|fas fa-random
history|fas fa-history
fonticons|fab fa-fonticons
venus|fas fa-venus
firstdraft|fab fa-firstdraft
rocketchat|fab fa-rocketchat
copyright-regular|far fa-copyright
google-plus|fab fa-google-plus
cloudsmith|fab fa-cloudsmith
uikit|fab fa-uikit
rss|fas fa-rss
list|fas fa-list
twitter-square|fab fa-twitter-square
inbox|fas fa-inbox
opencart|fab fa-opencart
play|fas fa-play
map-signs|fas fa-map-signs
arrow-circle-down|fas fa-arrow-circle-down
moon|fas fa-moon
arrow-circle-up|fas fa-arrow-circle-up
bicycle|fas fa-bicycle
ethereum|fab fa-ethereum